一个圆锥的母线长为五底面半径为三则圆锥的轴截面的面积为	一圆锥母线长20cm,母线与轴的夹角为30°,一个平行于该圆锥底面的平面截该圆锥,底面半径是截面半径的2倍,求底面和截面的面积,截面与底面的距离	1
已知a加b等于五ab等于三求代数式a的三次方b	当x等于三时,代数式ax的五次方加b x的三次方加三的值等于七,求当x等于-3代数式ax的五次方加b x的三次方加三的值等于多少?	1
若关于x的方程x减二的平方等于负m的平方有几方程的解为	已知关于x方程x平方减二mx等于负m平方加二x	1
关于x的一元二次方程x的平方加bx加c等于零的两个实数根分别为二和三求bbc的值	一元二次方程kx平方--bx+9=0有实数根,求K的取值范围	1
你对结尾这一点火焰是不会熄灭的它将永远燃着正像一个母亲的演得更像一个孩子	这一点火焰是不会熄灭的.他将永远燃着,正像一个母亲的眼泪,正像一个儿子的英勇,那样永垂不朽了.仿句	2
等腰三角形腰为二倍根号三顶角为40度底边为多少	若等腰三角形的底边长是腰长的根号3倍，则顶角为多少度	1
二x平方减三s括号乘ist文件下来又见一括号减二因式分解	用因式分解法解三x减一括起来的平方等于四乘括号里一减x括号起来的平方	1
已知直角三角形的各边长为正整数它的周长是八十求三边长	已知直角三角形的各边长为正整数，它的周长为80，求三边长	3
举出一项对当今人类产生较大影响的化学研究成果	举出一例当今人类生活产生较大影响的化学研究成果	3
化学上常用燃烧法确定有机物的组成这种方法是在电炉里加热时用纯氧气氧化管内	化学上常用燃烧法确定有机物的组成各种方法是在电炉加热时用纯氧气氧化管内样品根据产物的质量确定有机物的	2
已知函数fx等于罗恩一减二x分之a的定义域为一到正无穷则实数a的值为	已知函数f(x)=ln(1-a/2^x)的定义域是(1,正无穷),则实数a的值为	3
我最喜欢的商店这边短文中我喜欢书店的原因是什么	我最喜欢什么的作文,喜欢的原因是什么	1
我们爱你中国这首诗是按照什么结构写的	《我们爱你啊,中国》这首诗中赞美祖国幅员辽阔的诗句是?	1
新闻的表达方式以叙述为主有时还可以借用议论和抒情对吗	新闻主要表达方式是记叙,有时兼有议论、描写。对么?	3
若观察花生切片标本材料一半清晰一半模糊不清咋克隆有花香切片的什么造成的	在显微镜下观察花生切片时,切片薄厚不均为什么会造成一半模糊一半清晰?	3
在量取液体时俯视和仰视得到的结果是什么样的	化学中量取液体仰视俯视刻度与正常相比怎么样 读数时仰视俯视又会怎样	3
据材料分析孔子所说的人的主要内容孔子强调仁的主要目的是什么	孔子所说的仁的主要内容有哪些孔子强调仁的主要目的是什么孔子仁的思想具有什么现实意义	3
笔尖飞舞那是春蚕悄悄地编织理想的丝线中春蚕指的是什么	笔尖飞舞那是春蚕悄悄地编织理想的丝线是什么修辞手法	1
一共做了八条船每条船必须要坐满大船可以坐六人小船可以坐四人	全班一共有38人共租了八条船,每条船都坐满了,大小船各租了几条大船六人小船四人	2
已知全集u等于ra等于x大于负四小于等于一的集合则a的补集a在u中的补集等于多	已知全集U=R.集合P={X|X2小于或等于1}.则P的补集CUP=?	1
图一杠二杠七是某电场区域的电场线分布	如图是电场中某区域的电场线分布图,a、b是电场中的两点.这两点比较是什么?	1
若向新制氯水中滴加硝酸银溶液预计观察到的现象是气流是	若向新制氯水中滴加碳酸钠溶液,观察到的现象为	2
给试管加热时试管外壁附有水珠造成的不良后果是	被加热的试管外壁有水造成的不良后果	3
摄氏温度的规定在一个标准大气压下纯净的冰水混合物温度定为零摄氏度沸腾时的	摄氏温度的规定：在一个标准大气压下，纯净的冰水混合物的温度定为0℃，水沸腾时的温度定为100℃．将0～100℃之间划分为100等分，每一等分就是1℃．华氏温度的规定：在一个标准大气压下，纯净的冰水混合物的温度定为32℉（℉，读作华氏度），水沸腾时的温度定为212℉．将32～212℉之间划分为180等分，每一等分就是l℉．则华氏温度F与摄氏温度t之间的关系是F=______℉．人的正常体温大约为______℃，等于______℉．	2
如图所示在角abc中ab等于二ac等于三bc等于四adbfc为角abc的三条高	已知,如图所示,角1=角abc,角2=角3,be垂直ac,试说明fg垂直ac	1
已知关于x的方程x方减括号2k加一括乘以x	四乘以括号x加一括止的平方减七乘以括号x减一括止乘以括号x加一括止加三乘以括号一减x括止的平方	1
phc的平方减三x加p的平方减p等于零等于零	X的平方减六X加三等于零	1
啊老桥你如一位德高望重的老人在做借水上站了几百年的吧体会这个好处	啊老桥你如一位德高望重的老人在这涧水上站了几百年了吧?}体会这样写的好处再写出类似的句子	3
如图平行四边形abcd的周长为8c边上的高线de等于二分之1ad乘ab等于x平行四边形	已知平行四边形ABCD的周长是80,AB边上的高DE=2分之1AD.若设AB=X,平行四边形ABCD的面积为Y,求关于X的函数	1
几十几点三乘几十八等于几千几百几十七点几	八十几除以几十几等于三点几?	1
每摩尔任何物质都含有六点零二乘以十的23次方个威力这句话是否正	一摩尔氢含有六点零二乘以十的23个电子这句话是真心的吗	2
潘阳湖的面积是三千九百六十平方千米洞庭湖的面积比潘阳湖的三分之一还多一千	潘阳湖的面积是3960平方千米,洞庭湖的面积比潘阳湖面积的三分之一大1500平方千米,洞庭湖的面积是多少	2
二次函数y等于fx图像过点负1020期函数最小值为负二分之九	已知二次函数的图像过点(－2,0),(6,0),最小值为“负二分之九”,求二次函数的解析式.	1
下阕中有一句粪土当年万户侯其中的粪土是什么作用	'粪土当年万户侯''中的意动用法有什么作用	2
下列关于蒸发和沸腾下列说法不正确的是a蒸发可以在任何	下列关于蒸发,沸腾和液化的说法正确的是	1
欧阳修醉翁亭记中的醉翁亭在今天的哪个省份	欧阳修的醉翁亭记中,	2
若集合a等于x等于二n加一n属于自然数集合b等于x等于四n减一n属于自然数则a和b	已知集合A{x[x=3n次,n属于自然数},B={x[x=3n,n属于自然数},求A与B的交集和并集	1
某种农药二分之三千克加水稀后可琵萨一公顷的菜地坯洒五分之一公顷菜地需要多	某种农药二分之三千克加水稀释后可喷洒一公顷的菜地喷洒五分之一公顷菜地需要多少千克的农药	3
若一个多项式与三x平方加二y平方的和是x平方加xy减二分之一y的平方求这个多项	一个多项式加上x平方y减三xy平方得二x平方y减xy平方,则这个多项式是	1
一头成年大象的体重为十多亿的传言东北虎的体重是指成年大象的资本字十分之三	一只东北虎体重240千克,一头大象的体重是东北虎的25倍,又是一头牛	1
窃读记中的冲突来找一篇这句诗的作者什么的描写是作者对自己的什么	窃读记中”从头来,再找一遍是作者对自己的什么	3
如果点a表示的数既不是质数也不是负数那么点ce表示的数分别是什么	7	0
硫酸铜晶体受热分解失去结晶水的化学方程式	硫酸铜晶体受热失去结晶水的化学方程式	3
山中访友从哪些描写中可以看出作者和山中的朋友的深厚情谊	山中访友哪些描写看出我与朋友的深厚情谊	3
为什么除去甲烷中的乙烯酯可以用绿水酸性高锰酸钾	甲烷中混油乙烯可以用酸性高锰酸钾除去乙烯吗?	3
七律长征开头两句与下边六句之间是什么关系视作分析	七律 长征》开头两句与下边六句之间是什么关系	3
如图抛物线y等于ax方加bx加c过点一零和点	如图所示已知抛物线y等于ax平方加bx加c过点a括号负一零	2
在一条长绳的一端系一个小铁块就成做成了一个白要测出它摆动一个来回所用的时	在一条长绳的一端系一个小铁块就做成了一个摆.要测出它摆动一个来回所用的时间,怎样能测得更准确?	2
长方体左边一个长方形它的长是六宽是八这样对吗	一个长方体的长为48厘米长与宽的比为八比三宽与高的比为二比一长方形的体积是	1
一辆汽车行驶二分之二十五千米耗油一升汽油照这样计算这两	一辆汽车每行驶4千米耗油七分之四,照这样计算,一升汽油可行驶几千米?	1
草原上有四口油井位于图中是的abcd4个位置现在要建立一个维修站hyh键在何处才	草原上有四口油井,位于四边形ABCD的4个顶点,现在要建一个维修站H,试问H建在何处	3
下列离子方程式错误的是a向氢氧化钡溶液中滴加稀硫酸的酸性介质中高锰酸钾氧	氢氧化钡中滴加过量稀硫酸为什么无离子方程式	1
如图所示轻质弹簧一端固定另一端与一质量为m靠在粗糙竖直固定杆a处的圆环连接	如图所示,轻质弹簧一端与竖直墙面连接,另一端与放在粗糙水平面上的小木块固定连接	2
钓鱼岛是中国的固有领土我国海警在钓鱼岛周边海域巡航的过程	钓鱼岛自古以来是我国的固有领土，请用物理知识解释常年岛上的一天气温变化只有2℃左右？我海监船队去钓鱼岛海域巡航时，为何采用“一”字形航行？	1
把描写教室窗外安静的句子工工整整的抄写在下面	工工整整的近义词	0
设二次函数fx等于ax方加bx加c满足条件当x属于r时fx的最大值为	二次函数fx等于ax方加2ax加1，在R内最大值为4求实数a的值	1
如图所示是一个带正电的验电器当一个金属球a靠近验电器上的金属小球b时	一个带正电的验电器如图所示,当一个金属球A靠近验电器金属球B时,验电器中金属箔片张角减小	2
如图已知三角形abc的三个顶点坐标分别为a负40b10c负二六	如图已知三角形abc的三个顶点的坐标分别为a负23b负60c负一零写出a关于y轴对称	2
物理变化只是物质的什么和什么发生变化	物理变化一般只是物质的什么发生了变化	3
一剪b的差的m次方乘以a减b的差的二次方	m减n的差的3次方加2n乘n减m的差的二次方	1
四两五二氧化硅晶体中含有的硅氧键数目为零点三乘n	4.5g二氧化硅晶体中含有的硅氧键的数目为多少	1
用来描绘人们热爱读书学习的成语有哪些至少四个	用来描绘人们热爱读书学习的词语.（至少四个）	3
如图所示装置电解水反应一段时间后对有关现象和	某同学制作了如图所示的简易电解水装置,进行家庭小实验（注：该装置气密性良好,且反应一段时间后	1
写出下列反应的化学方程式并注明反应类型一铁粉与硫粉混合加热生成硫化亚铁	将21克铁粉和8克硫粉混合加热,能生成硫化亚铁多少克?	1
在送杜少府之蜀州这首诗中表达作者积极进取昂扬奋发的人生态度的诗句是	《送杜少府之任蜀州》这首诗表达了作者怎样的思想感情?	1
如果函数在x等于二x减三x在0fxx小于零是奇函数则fx等于	已知函数fx是定义域为R的奇函数,当X小于等于零,fx等于负x的平方加x,则当x大于0,fx等于?	1
雅鲁藏布大峡谷课文的三四自然段是从大峡谷的什么什么以及什么等方面描绘了大	雅鲁藏布大峡谷课文的文体	1
已知xy满足根号2x减三y加一家绝对值x减三y减二等于零求xy的算式平方根	已知根号下三x减二y减五加三x减六的绝对值等于0,求xy的算术平方根	1
只有边长是一千米的正方形面积才是一平方千米是对还是错	占地面积一平方千米的正方形牧场边长增加一千米,这个牧场的面积增加多少公顷?	1
在日常生活中在哪可以找到微生物的踪迹你能用什么办法证明它们是有生物的	如何证明在我们的日常生活中,微生物无处不在?	3
旗鱼是游得最快的鱼游行速度可达每小时一百二十千米猎豹是陆地上跑得最快的动	旗鱼是游的最快的鱼,每小时可游120千米,猎豹是陆地上跑得最快的动物,它的速度比锦鱼还要快1/6.它的速度是多少?	2
如图铁路mn和公路pq在点o处交汇角qon等于三十度	如图,铁路MN和公路PQ在点O处交汇,∠QON=30°,再点	2
正方形abde与正方形acjfm为bc中点直线am交ef于n求证an垂直efam等于二分gex	四边形ABDE与四边形ACGF均为正方形M为BC中点直线AM交EF于N 求证AM垂直EFAM=二分之	3
已知等腰三角形的周长是25cm其中一边长为12cm求另两边长	已知等腰三角形的周长为12cm其中一边的长为5cm求另外两边的长	2
如图在三角形abc中角bac等于角b60ab等于ac点e	如图三角形abc中射线ad平分角bac,ad交bc于e点 若ab大于ac角bac等于角bdc等于	1
随着人们生活水平的提高越来越多的国家采用水地暖进行曲之	随着人们生活水平的提高越来越多的家庭采用‘’水暖地‘’其原理是	2
如果一个四边形是轴对称图形而且有两条互相垂直的对称轴那么这个四边形一定是	如果一个四边形是轴对称图形,并且有两条互相垂直的对称轴,它一定是菱形吗?一定是	2
分析散步这篇课文中地人物这几个人物分别给你留下了什么印象	课文塑造的“妈妈”这一人物形象给我们留下了深刻的印象，试分析这一人物。	1
用简便方法计算六点一的平方加十二点二乘三点九加三点九的平方	六点一的平方加十二点二乘以三得九加三得九的平方简便方法方&#65533;	3
施工人员用挖掘机开挖地基挖掘机每次可将零点八立方米的泥土举高三米饮水便宜	施工人员用挖掘机开挖地基,挖掘机每次可将0.8立方米的泥土举高三米并水平移动5米后倒入卡车货箱,此过程中挖掘机对泥土做了多少功{泥土的密度为1.5乘10的三次方千克每立方米,g取10牛每千克}	2
一列火车两百米每小时七十二千米的速度垣间通过一座长为一点八千米的大桥用火	火车长两百米以速度为七十二千米每小时通过一座长一点二千米的大桥丘火车过桥时时问	2
rt三角形abc中角c等于九十度ac等于角bdc等于三ab等于角c将三角形分别绕边bcac	在rt三角形abc中角c等于九十度ab等于二倍bcac等于六那么bc等于多少	1
胡服骑射是哪一个君王为了强大战国而提出的	胡服骑射的英语翻译	0
静止在桌面上的木块没有动能有平均动能	静止在桌面上的木块有动能吗,由分子平均动能吗?	3
丁基有四种异构体分子式c4h9cl的历代清宫有几种	分子式为C4H9Cl的同分异构体有几种	3
一天早晨的气温是负七摄氏度中午上升了十一摄氏度半夜又下降了九是适度半夜的	一天早晨的气温是负7摄氏度,中午上升了11摄氏度,半夜下降了9摄氏度,半夜的气温是多少摄氏度?	2
四点零克硫粉在氧气中完全燃烧生成二氧化硫放出三十七千焦热量计算硫的燃烧热	4克硫粉在氧气中完全燃烧生成二氧化硫,放出37千焦热量,计算硫的燃烧热,	3
多细胞生物依靠什么密切合作共同完成一系列复杂的生命活动	许多植物和动物是多细胞生物,它们依赖什么密切合作,共同完成一系列复杂的生命活动?	3
音调指声音的什么是由物体振动的什么决定的响度指声音的什么是由物体振动的什	音调指声音的——,由声源振动——决定	3
在三角形abc中a1平分角bac角c大于角bf为ae上的一点且fd垂直bc于点p	在三角形ABC中,AE平分角BAC,角C大于角B,F为AE上一点,且FD垂直于BC于D	2
一个四棱柱的底面是等腰梯形上下两个底	请画一个底面为等腰梯形的直四棱柱	1
在一棵树的十米高b处有两只猴子一只猴子爬下树倒的树二十米处的池塘a处另一只	在一棵树的10米高的B处有两只猴子，一只猴子爬下树走到离树20米处的池塘A处，另一只猴子爬到树顶D处后直接	2
十五的正因数的全体所构成的集合是什么	求15的正因数的全体所构成的集合?	3
甲乙两人从两地同时相对而行经过四小时在距离中点四千米处相遇甲比乙速度快甲	甲乙二人从两地同时相对而行,经过四小时.在距离中点四千米处相遇.甲比乙速度快,甲每小时比乙快多少千米?	2
a前三秒内和前五秒内位移相等的前四秒内位移为零	初速度为零的匀加速直线运动,前三秒内位移18米,它第五秒内的位移为多少?	1
菱形abcd的对角线ac等于十厘米bc等于六厘米求角bac的余弦值	九年级下册如图菱形abcd中对角线ac等于十厘米bd等于六厘米求sin角dac的值	2
一建工程甲单独做a小时未完成乙单独做需b小时完成如果两人合作三小时后	一件工程若甲单独做需三小时完成,乙独做五小时完成,则两人合作x小时完成了多少	2
我知道课文以窃读为线索以放学后急匆匆赶到书店到晚上依依不舍离开的诗	窃读记一文以放学后急匆匆地赶到书店到晚上依依不舍离开的时间顺序和（ ）、（ ）两个场景的插入,表现“我”（ ）	2
在密闭容器中加入一点五摩尔氢气和零点五摩氮气充分反应后得到氨气分子数为na	在密闭容器中加入一点五摩尔氢气和零点五摩尔氨气充分反应可得到NH3的分子数为	3
广泛用于玻璃造纸纺织和洗涤剂的生产物品是什么	广泛用于玻璃,造纸,纺织和洗涤剂的生产的化学物质是什么	3
